11111111
1PCE0001
10000001
1111111
