1111111111
1P0E0C0001
1111111111

