1111111111
1P00C000E1
1111111111

